{
  "name": "Bangla (Munir Optical)",
  "id": "munir-optical",
  "type": "fixed",
  "keymap": {
    "q": "ধ", "w": "ূ", "e": "ী", "r": "র", "t": "ট", "y": "এ",
    "u": "ু", "i": "ো", "o": "ও", "p": "প", "a": "া", "s": "স",
    "d": "ড", "f": "ত", "g": "গ", "h": "হ", "j": "জ", "k": "ক",
    "l": "ল", "z": "য", "x": "ঢ়", "c": "চ", "v": "্", "b": "ব",
    "n": "ন", "m": "ম", "0": "০", "1": "১", "2": "২", "3": "৩",
    "4": "৪", "5": "৫", "6": "৬", "7": "৭", "8": "৮", "9": "৯"
  }
}