{
  "name": "Bangla (National Jatiya)",
  "id": "national-jatiya",
  "type": "fixed",
  "keymap": {
    "`": "ঞ", "1": "১", "2": "২", "3": "৩", "4": "৪", "5": "৫",
    "6": "৬", "7": "৭", "8": "৮", "9": "৯", "0": "০", "-": "-",
    "q": "দ", "w": "ূ", "e": "ী", "r": "র", "t": "ট", "y": "এ",
    "u": "ু", "i": "ো", "o": "ও", "p": "প", "a": "া", "s": "স",
    "d": "ড", "f": "ত", "g": "গ", "h": "হ", "j": "জ", "k": "ক",
    "l": "ল", ";": "ো", "z": "য", "x": "ঢ়", "c": "চ", "v": "্",
    "b": "ব", "n": "ন", "m": "ম"
  }
}